6 6 6 6 6 6 6 6 6 6 6 6 6 6 6 6 6 6 6 6 6 6 6 6 6 6 6 6 6 6 6 6 6 6 6 6 6 6 6 6 6 6 6 6 6 6 6 6 6 6 
7 8 7 6 7 8 8 7 6 7 8 8 7 8 6 7 8 6 7 7 6 7 8 7 6 8 8 7 6 7 8 8 7 8 6 7 8 6 7 7 6 7 8 7 6 7 6 8 7 6 
7 8 7 1 17 1 1 2 1 1 17 1 1 1 2 17 1 1 1 17 1 1 17 1 1 2 1 7 20 18 18 18 18 18 18 18 18 18 18 18 19 8 8 7 47 7 6 8 7 6 
7 8 7 1 7 8 8 7 6 7 8 8 7 8 6 7 8 6 7 7 6 7 8 7 6 8 6 7 24 25 12 12 25 25 12 25 12 25 25 12 23 8 8 7 29 7 6 8 7 6  
7 8 7 1 7 8 8 7 6 7 8 8 7 8 6 7 8 6 7 7 6 7 8 7 6 8 6 7 24 12 25 25 12 12 25 25 25 12 12 25 23 8 8 7 29 7 6 8 7 6 
7 8 7 1 7 8 8 7 6 7 8 8 7 8 6 7 8 6 7 7 6 7 8 7 6 8 6 7 24 25 12 12 25 25 12 25 12 25 25 12 23 8 8 7 29 7 6 8 7 6 
7 8 7 17 7 8 8 7 36 38 38 38 38 38 38 38 38 38 38 38 38 38 38 38 38 38 38 37 24 12 25 25 12 12 25 25 25 12 12 25 23 2 17 48 29 48 17 17 17 6 
7 8 7 1 7 8 8 7 29 8 8 8 8 8 8 8 8 8 8 8 8 8 8 8 8 8 8 29 24 25 12 12 25 25 12 25 12 25 25 12 23 17 2 48 29 48 2 17 17 6
7 8 7 17 7 8 8 7 29 8 46 2 17 50 50 2 2 46 46 46 46 46 2 2 2 50 8 29 24 12 25 25 12 12 25 25 25 12 12 25 23 2 17 48 29 48 2 17 2 6
7 8 7 2 7 8 8 7 29 2 17 17 2 17 17 50 17 2 1 46 2 17 2 1 17 2 8 29 21 26 26 26 26 26 26 26 26 26 26 26 22 17 2 48 29 48 17 50 50 6
7 8 1 1 7 8 8 7 29 2 17 17 2 1 46 50 2 17 2 46 2 17 50 46 2 50 8 34 38 38 38 37 2 17 50 1 17 2 17 2 17 2 50 48 29 48 2 17 50 6
7 8 1 6 7 8 8 7 29 8 46 2 17 2 17 2 17 2 17 2 17 2 17 2 17 2 8 8 8 8 8 29 2 17 46 46 2 2 17 2 17 2 50 48 29 48 17 50 50 6
7 8 17 6 7 8 8 7 29 8 2 17 2 46 2 1 2 46 2 17 17 2 17 2 17 2 17 2 17 17 8 29 2 17 50 46 46 2 17 2 17 2 1 48 29 48 2 17 2 6
7 8 1 6 7 8 8 7 29 8 44 44 44 44 44 44 44 44 44 44 44 44 44 44 44 44 44 44 44 44 43 29 43 44 44 44 44 44 44 44 44 44 44 44 29 44 44 44 1 6
7 8 1 6 7 8 8 7 30 38 38 38 38 38 38 38 38 38 38 38 38 38 38 38 38 38 38 38 38 38 38 4 38 38 38 38 38 38 38 38 38 38 38 38 33 38 38 38 38 6
7 8 1 6 7 8 8 7 29 49 49 49 49 49 49 49 49 49 49 49 49 49 49 49 49 49 49 49 49 49 43 29 43 50 2 17 50 50 2 17 17 17 50 2 2 2 17 50 50 6
7 8 1 6 7 8 8 7 29 6 2 17 17 50 46 17 2 50 17 2 17 17 2 17 2 17 2 17 2 17 42 29 42 2 17 46 46 17 2 17 2 17 2 50 50 50 2 17 17 6
7 8 1 6 7 8 8 7 29 6 17 2 50 46 2 17 2 17 17 17 2 17 50 17 2 17 2 2 2 17 42 29 42 46 2 17 46 50 2 17 17 17 50 2 2 2 17 50 50 6
7 8 1 6 7 8 8 7 29 6 2 17 17 1 46 17 2 1 17 2 17 17 2 17 2 17 2 17 2 17 42 29 42 46 2 17 50 50 2 17 17 17 50 2 2 2 17 50 50 6
7 8 17 6 7 8 8 7 29 6 17 2 50 2 17 2 17 17 17 2 17 17 17 2 17 17 1 46 46 17 42 29 42 2 17 2 17 46 50 2 17 17 17 17 2 50 50 2 17 6
7 8 1 6 7 8 8 7 29 6 17 2 50 46 2 17 2 17 17 17 2 17 50 17 2 17 2 2 2 17 42 29 42 46 2 17 50 50 2 17 17 17 50 2 2 2 17 50 50 6
7 8 1 6 7 8 8 7 29 17 2 17 2 50 2 17 2 17 17 17 2 17 17 17 2 17 17 50 46 46 42 29 42 2 17 50 50 17 2 17 2 17 2 50 50 50 2 17 17 6
7 8 1 6 7 8 8 7 29 17 50 2 17 2 17 2 2 17 17 17 2 2 14 14 14 14 14 2 50 2 42 29 42 2 17 50 50 2 17 39 41 39 41 39 39 41 39 39 41 6
7 8 1 1 1 1 1 7 29 6 50 2 17 2 17 2 17 2 50 46 2 17 14 15 15 15 14 50 17 46 42 29 42 1 2 17 2 17 50 41 36 32 32 32 32 32 32 32 37 6
7 8 1 6 7 8 1 7 29 6 2 17 2 17 50 50 46 46 46 2 50 2 14 15 15 15 14 39 41 39 39 29 41 39 41 39 41 39 41 39 30 4 40 4 4 40 4 4 31 6
7 8 1 6 7 8 2 7 29 6 2 50 46 2 2 50 46 2 50 2 46 2 14 15 15 15 14 38 38 38 38 33 38 38 38 38 38 38 38 38 4 4 4 4 4 40 4 4 31 6
7 8 2 6 7 8 17 7 29 8 8 8 8 8 8 8 8 8 8 8 8 8 14 14 15 14 14 8 8 8 8 8 8 8 8 8 8 8 8 8 30 4 40 4 4 4 40 4 31 6
7 8 1 6 7 8 1 7 29 46 46 2 46 17 46 2 46 17 46 2 46 17 45 46 17 46 45 17 46 17 46 2 46 17 46 2 46 17 46 2 30 4 4 4 40 4 4 40 31 6
7 8 1 6 7 8 1 7 29 2 17 2 17 2 17 2 17 2 17 2 17 2 17 2 17 2 17 2 17 2 17 2 17 2 17 2 17 2 17 2 30 4 4 40 4 4 4 4 31 6
7 8 1 6 7 8 1 7 7 7 7 7 7 7 7 7 7 7 7 7 7 7 7 6 2 6 7 7 7 7 7 7 7 7 7 7 7 7 7 7 34 33 33 33 33 33 33 33 35 6
7 8 17 6 7 8 1 7 20 18 18 18 18 18 18 18 18 18 18 18 18 18 18 19 27 20 18 18 18 18 18 18 18 18 18 18 18 18 18 18 18 18 18 18 18 18 18 18 18 18
7 8 1 6 7 8 17 7 24 25 12 25 12 25 12 25 12 25 12 25 12 25 12 23 27 24 12 25 12 25 12 25 12 25 12 25 12 25 12 25 28 26 26 26 26 26 26 26 26 26
7 8 1 6 7 8 1 7 24 12 25 12 25 12 25 12 25 12 25 12 25 12 25 23 27 24 25 12 25 12 25 12 25 12 25 12 25 12 25 12 23 6 6 7 7 8 8 7 8 6
7 8 1 6 7 8 1 7 24 25 12 25 12 25 12 25 12 25 12 25 12 25 12 23 27 24 12 25 12 25 12 25 12 25 12 25 12 25 12 25 23 7 16 16 16 16 16 7 8 6
7 8 1 6 7 8 1 7 24 12 25 12 25 12 25 12 25 12 25 12 25 12 25 23 27 24 25 12 25 12 25 12 25 12 25 12 25 12 25 12 23 8 16 5 5 5 16 7 8 6
9 9 3 9 9 8 2 7 24 25 12 25 12 25 12 25 12 25 12 25 12 25 12 23 27 24 12 25 12 25 12 25 12 25 12 25 12 25 12 25 23 7 16 5 5 5 16 8 8 6
9 3 3 3 9 8 1 7 24 12 25 12 25 12 25 12 25 12 25 12 25 12 25 23 27 24 25 12 25 12 25 12 25 12 25 12 25 12 25 12 23 6 16 5 5 5 16 6 8 6
9 3 3 3 9 8 17 7 24 25 12 25 12 25 12 25 12 25 12 25 12 25 12 23 27 24 12 25 12 25 12 25 12 25 12 25 12 25 12 25 23 7 16 16 5 16 16 8 8 6
9 3 3 3 9 8 2 7 24 25 12 25 12 25 12 25 12 25 12 25 12 25 12 23 27 24 25 12 25 12 25 12 25 12 25 12 25 12 25 12 23 6 7 8 29 6 6 7 8 6
9 9 9 9 9 8 17 7 24 12 25 12 25 12 25 12 25 12 25 12 25 12 25 23 27 24 12 25 12 25 12 25 12 25 12 25 12 25 12 25 23 8 7 6 29 7 6 8 8 6
7 8 7 6 7 8 2 7 24 25 12 25 12 25 12 25 12 25 12 25 12 25 12 23 27 24 25 12 25 12 25 12 25 12 25 12 25 12 25 12 23 7 6 8 29 6 7 8 7 6
7 8 7 6 7 8 17 7 21 26 26 26 26 26 26 26 26 26 26 26 26 26 26 22 27 21 26 26 26 26 26 26 26 26 26 26 26 26 26 26 22 6 7 8 29 8 7 6 8 6
7 8 7 6 7 8 27 27 27 27 27 27 27 27 27 27 27 27 27 27 27 27 27 27 27 27 27 27 27 27 27 27 27 27 27 27 27 27 27 27 27 27 27 27 27 27 27 27 27 6
18 18 18 18 18 18 18 18 18 18 18 18 18 18 18 18 18 18 18 18 18 18 18 19 27 20 18 18 18 18 18 18 18 18 18 18 18 18 18 18 18 18 18 18 18 18 18 18 18 18
25 12 25 12 25 12 25 12 25 12 25 12 25 12 12 25 12 25 12 25 12 25 12 23 27 24 25 12 25 12 25 12 25 12 25 12 25 12 25 12 12 25 12 25 12 25 12 25 12 25 
25 12 25 12 25 12 25 12 25 12 25 12 25 12 12 25 12 25 12 25 12 25 12 23 27 24 12 25 25 25 12 12 12 25 25 25 12 12 25 25 25 12 12 25 25 12 12 12 25 25
25 12 25 12 25 12 25 12 25 12 25 12 25 12 12 25 12 25 12 25 12 25 12 23 27 24 12 25 25 25 12 12 12 25 25 25 12 12 25 25 25 12 12 25 25 12 12 12 25 25
26 26 26 26 26 26 26 26 26 26 26 26 26 26 26 26 26 26 26 26 26 26 26 22 27 21 26 26 26 26 26 26 26 26 26 26 26 26 26 26 26 26 26 26 26 26 26 26 26 26
6 27 27 2 27 17 27 27 27 27 2 27 17 27 27 27 27 27 27 2 27 27 27 7 27 7 27 27 27 17 27 27 2 27 27 27 2 27 27 17 27 27 17 27 27 27 2 27 27 6 
6 7 7 6 7 6 7 6 7 6 6 7 7 6 6 7 7 6 7 6 7 6 7 7 1 7 7 6 6 6 7 7 7 6 6 6 7 7 6 6 7 6 7 6 7 6 7 7 7 6 