6 6 6 6 6 6 6 6 6 6 6 6 6 6 6 6 6 6 6 6 6 6 6 6 61 6 6 6 6 6 6 6 6 6 6 6 6 6 6 6 6 6 6 6 6 6 6 6 6 6 
6 7 7 6 7 6 7 6 7 6 6 7 7 6 6 7 7 6 7 6 7 6 7 7 29 7 7 6 6 6 7 7 7 6 6 6 7 7 6 6 7 6 7 6 7 6 7 7 7 6
18 18 18 18 18 18 18 18 18 18 18 18 18 18 18 18 18 18 18 18 18 18 18 19 29 20 18 18 18 18 18 18 18 18 18 18 18 18 18 18 18 18 18 18 18 18 18 18 18 18 
25 12 25 25 12 25 12 25 12 25 12 12 25 25 25 12 12 25 25 12 25 12 12 23 29 24 12 25 12 25 25 12 25 25 12 25 25 12 25 12 12 12 25 25 12 25 12 12 25 25
12 25 12 25 25 12 25 25 12 25 25 12 25 12 12 12 25 25 12 25 12 12 25 23 29 24 12 25 25 12 25 25 12 25 12 25 12 25 12 12 25 25 25 12 12 25 25 12 25 12
25 12 25 25 12 25 12 25 12 25 12 12 25 25 25 12 12 25 25 12 25 12 12 23 29 24 12 25 12 25 25 12 25 25 12 25 25 12 25 12 12 12 25 25 12 25 12 12 25 25
12 25 12 25 25 12 25 25 12 25 25 12 25 12 12 12 25 25 12 25 12 12 25 23 29 24 12 25 25 12 25 25 12 25 12 25 12 25 12 12 25 25 25 12 12 25 25 12 25 12 
25 12 25 25 12 25 12 25 12 25 12 12 25 25 25 12 12 25 25 12 25 12 12 23 29 24 12 25 12 25 25 12 25 25 12 25 25 12 25 12 12 12 25 25 12 25 12 12 25 23
12 25 12 25 25 12 25 25 12 25 25 12 25 12 12 12 25 25 12 25 12 12 25 23 29 24 12 25 25 12 25 25 12 25 12 25 12 25 12 12 25 25 25 12 12 25 25 12 25 12 
25 12 25 25 12 25 12 25 12 25 12 12 25 25 25 12 12 25 25 12 25 12 12 23 29 24 12 25 12 25 25 12 25 25 12 25 25 12 25 12 12 12 25 25 12 25 12 12 25 25
12 25 12 25 25 12 25 25 12 25 25 12 25 12 12 12 25 25 12 25 12 12 25 23 29 24 12 25 25 12 25 25 12 25 12 25 12 25 12 12 25 25 25 12 12 25 25 12 25 12 
25 12 25 25 12 25 12 25 12 25 12 12 25 25 25 12 12 25 25 12 25 12 12 23 29 24 12 25 12 25 25 12 25 25 12 25 25 12 25 12 12 12 25 25 12 25 12 12 25 25
12 25 12 25 25 12 25 25 12 25 25 12 25 12 12 12 25 25 12 25 12 12 25 23 29 24 12 25 25 12 25 25 12 25 12 25 12 25 12 12 25 25 25 12 12 25 25 12 25 12 
25 12 25 25 12 25 12 25 12 25 12 12 25 25 25 12 12 25 25 12 25 12 12 23 29 24 12 25 12 25 25 12 25 25 12 25 25 12 25 12 12 12 25 25 12 25 12 12 25 25
12 25 12 25 25 12 25 25 12 25 25 12 25 12 12 12 25 25 12 25 12 12 25 23 29 24 12 25 25 12 25 25 12 25 12 25 12 25 12 12 25 25 25 12 12 25 25 12 25 12 
12 25 28 26 26 26 26 26 26 26 26 26 26 26 26 26 26 26 26 26 26 26 26 22 29 21 26 26 26 26 26 26 26 26 26 26 26 26 26 26 26 26 26 26 26 26 26 53 25 25 25
25 12 23 27 17 27 17 27 27 17 27 27 17 27 17 27 27 27 17 17 17 27 2 27 29 17 27 17 27 27 17 27 27 2 2 17 27 27 27 17 17 17 27 27 27 27 27 24 25 12 12
25 12 23 27 17 27 17 27 27 17 27 27 17 27 17 27 27 27 17 17 17 27 27 17 29 27 17 27 17 27 27 2 2 27 17 27 17 27 27 27 17 17 17 27 27 27 27 24 25 12 12
25 12 23 27 17 27 17 27 27 17 27 27 17 27 17 27 27 27 17 17 17 27 2 27 29 27 17 27 17 27 27 2 2 27 17 27 17 27 27 27 17 17 17 27 27 27 27 24 25 12 12
25 12 23 27 17 27 17 27 27 17 27 27 17 27 17 27 27 27 17 17 17 27 2 27 29 2 2 27 17 2 27 17 27 17 27 27 27 2 2 17 27 2 2 27 2 17 27 24 25 12 12
25 12 23 27 17 27 17 27 27 17 27 27 17 27 17 27 27 27 17 17 17 27 2 27 29 17 2 17 27 17 2 2 17 27 27 17 27 17 27 27 27 17 17 17 27 27 27 24 25 12 12
25 12 23 27 17 27 17 27 27 17 27 27 17 27 17 27 27 27 17 17 17 27 27 17 29 17 2 17 27 17 2 2 17 27 27 17 27 17 27 27 27 17 17 17 27 27 27 24 25 12 12
25 12 23 27 17 27 17 27 27 17 27 27 17 27 17 27 27 27 17 17 17 27 27 17 29 27 17 27 17 27 27 2 2 27 17 27 17 27 27 27 17 17 17 27 27 27 2 24 25 12 12
25 12 23 27 17 27 17 27 27 17 27 27 17 27 17 27 27 27 17 17 17 27 27 17 29 2 2 17 27 17 2 2 17 27 27 17 27 17 27 27 27 17 17 17 27 27 27 24 25 12 12
25 12 23 27 17 27 17 27 27 17 27 27 17 27 17 27 27 27 17 17 17 27 2 27 29 2 2 27 17 2 27 17 27 17 27 27 27 2 2 17 27 2 2 27 17 2 2 24 25 12 12
25 12 23 51 51 51 51 51 51 51 51 51 51 51 51 51 51 51 51 51 51 51 51 51 56 51 51 51 51 51 51 51 51 51 51 51 51 51 51 51 51 51 51 51 51 51 51 24 12 12
25 12 23 51 51 51 51 51 51 51 51 51 51 51 51 51 51 51 51 51 51 51 51 56 56 56 51 51 51 51 51 51 51 51 51 51 51 51 51 51 51 51 51 51 51 51 51 24 12 12
25 12 23 51 51 51 51 51 51 51 51 51 51 51 51 51 51 51 51 51 51 51 56 56 56 56 56 51 51 51 51 51 51 51 51 51 51 51 51 51 51 51 51 51 51 51 51 24 12 12
25 12 23 51 51 51 51 56 56 56 56 56 56 56 56 56 56 56 56 56 56 56 56 56 56 56 56 56 56 56 56 56 56 56 56 56 56 56 56 56 56 56 56 51 51 51 51 24 12 12
25 12 23 51 51 51 51 56 56 56 56 56 56 56 56 56 56 56 56 56 56 56 56 56 56 56 56 56 56 56 56 56 56 56 56 56 56 56 56 56 56 56 56 51 51 51 51 24 12 12
25 12 23 51 51 51 51 56 56 56 56 56 56 56 56 56 56 56 56 56 56 56 56 56 56 56 56 56 56 56 56 56 56 56 56 56 56 56 56 56 56 56 56 51 51 51 51 24 12 12
25 12 23 51 51 51 51 56 56 56 56 56 56 56 56 56 56 56 56 56 56 56 56 56 56 56 56 56 56 56 56 56 56 56 56 56 56 56 56 56 56 56 56 51 51 51 51 24 12 12
25 12 23 51 51 51 51 56 56 56 56 56 56 56 56 56 56 56 56 56 56 56 56 56 56 56 56 56 56 56 56 56 56 56 56 56 56 56 56 56 56 56 56 51 56 51 51 24 12 12
25 12 23 51 51 56 51 56 56 56 56 56 56 56 56 56 56 56 56 56 56 56 56 56 56 56 56 56 56 56 56 56 56 56 56 56 56 56 56 56 56 56 56 56 56 56 51 24 12 12
25 12 23 51 56 56 56 56 56 56 56 56 56 56 56 56 56 56 56 56 56 56 56 56 56 56 56 56 56 56 56 56 56 56 56 56 56 56 56 56 56 56 56 51 56 51 51 24 12 12
25 12 23 51 51 56 51 56 56 56 56 56 56 56 56 56 56 56 56 56 56 56 56 56 56 56 56 56 56 56 56 56 56 56 56 56 56 56 56 56 56 56 56 51 51 51 51 24 12 12
25 12 23 51 51 51 51 56 56 56 56 56 56 56 56 56 56 56 56 56 56 56 56 56 56 56 56 56 56 56 56 56 56 56 56 56 56 56 56 56 56 56 56 51 51 51 51 24 12 12
25 12 23 51 51 51 51 56 56 56 56 56 56 56 56 56 56 56 56 56 56 56 56 56 56 56 56 56 56 56 56 56 56 56 56 56 56 56 56 56 56 56 56 51 51 51 51 24 12 12
25 12 23 51 51 51 51 56 56 56 56 56 56 56 56 56 56 56 56 56 56 56 56 56 56 56 56 56 56 56 56 56 56 56 56 56 56 56 56 56 56 56 56 51 51 51 51 24 12 12
25 12 23 51 51 51 51 56 56 56 56 56 56 56 56 56 56 56 56 56 56 56 56 56 56 56 56 56 56 56 56 56 56 56 56 56 56 56 56 56 56 56 57 51 51 51 51 24 12 12
25 12 23 51 51 51 51 56 57 56 56 56 56 56 56 56 56 56 56 56 56 56 56 56 56 56 56 56 56 56 56 56 56 56 56 56 56 56 56 56 56 56 56 51 51 51 51 24 12 12
25 12 23 51 51 51 51 56 56 56 56 56 56 56 56 56 56 56 56 57 56 56 56 56 56 56 56 56 56 56 56 56 56 57 56 56 56 56 56 56 56 56 56 51 51 51 51 24 12 12
25 12 23 51 51 51 51 56 56 56 56 56 56 56 56 57 56 56 56 56 56 56 56 56 56 56 56 56 56 57 56 56 56 56 56 56 56 56 56 56 56 56 56 51 51 51 51 24 12 12
25 12 23 51 51 51 51 56 56 56 56 56 56 56 56 56 56 56 56 56 56 56 56 51 56 51 56 56 56 56 56 56 56 56 56 56 56 56 56 56 56 56 56 51 51 51 51 24 12 12
25 12 23 51 51 51 51 51 51 51 51 51 51 51 51 51 51 51 51 51 51 51 51 51 56 51 51 51 51 51 51 51 51 51 51 51 51 51 51 51 51 51 51 51 51 51 51 24 12 12
25 12 23 51 51 51 51 51 51 51 51 51 51 51 51 51 51 51 51 51 51 51 51 56 56 56 51 51 51 51 51 51 51 51 51 51 51 51 51 51 51 51 51 51 51 51 51 24 12 12
25 12 23 51 51 51 51 51 51 51 51 51 51 51 51 51 51 51 51 51 51 51 56 56 56 56 56 51 51 51 51 51 51 51 51 51 51 51 51 51 51 51 51 51 51 51 51 24 12 12
25 12 54 51 51 51 51 51 51 51 51 51 51 51 51 51 51 51 51 51 51 51 56 56 60 56 56 51 51 51 51 51 51 51 51 51 51 51 51 51 51 51 51 51 51 51 51 55 25 12 
25 12 25 51 51 51 51 51 51 51 51 51 51 51 51 51 51 51 51 51 51 51 51 56 56 56 51 51 51 51 51 51 51 51 51 51 51 51 51 51 51 51 51 51 51 51 51 12 25 25
25 12 25 51 51 51 51 51 51 51 51 51 51 51 51 51 51 51 51 51 51 51 51 51 51 51 51 51 51 51 51 51 51 51 51 51 51 51 51 51 51 51 51 51 51 51 51 12 12 12 