2 17 2 17 2 17 2 17 2 17 2 17 2 17 2 17 2 17 2 17 2 17 2 17 2 17 2 17 2 17 2 17 2 17 2 17 2 17 2 17 2 17 2 17 2 17 2 17 2 17
2 17 2 17 2 17 2 17 2 17 2 17 2 17 2 17 2 17 2 17 2 17 2 17 2 17 2 17 2 17 2 17 2 17 2 17 2 17 2 17 2 17 2 17 2 17 2 17 2 17
2 17 2 17 2 17 2 17 2 17 2 17 2 17 2 17 2 17 2 17 2 17 2 17 2 17 2 17 2 17 2 17 2 17 2 17 2 17 2 17 2 17 2 17 2 17 2 17 2 17
2 17 2 17 2 17 2 17 2 17 2 17 2 17 2 17 2 17 2 17 2 17 2 17 2 17 2 17 2 17 2 17 2 17 2 17 2 17 2 17 2 17 2 17 2 17 2 17 2 17
2 17 2 17 2 17 2 17 2 17 2 17 2 17 2 17 2 17 2 17 2 17 2 17 2 17 2 17 2 17 2 17 2 17 2 17 2 17 2 17 2 17 2 17 2 17 2 17 2 17
2 17 2 17 2 17 2 17 2 17 2 17 2 17 2 17 2 17 2 17 2 17 2 17 2 17 2 17 2 17 2 17 2 17 2 17 2 17 2 17 2 17 2 17 2 17 2 17 2 17
2 17 2 17 2 17 2 17 2 17 2 17 2 17 2 17 2 17 2 17 2 17 2 17 2 17 2 17 2 17 2 17 2 17 2 17 2 17 2 17 2 17 2 17 2 17 2 17 2 17
2 17 2 17 2 17 2 17 2 17 2 17 2 17 2 17 2 17 2 17 2 17 2 17 2 17 2 17 2 17 2 17 2 17 2 17 2 17 2 17 2 17 2 17 2 17 2 17 2 17
2 17 2 17 2 17 2 17 2 17 2 17 2 17 2 17 2 17 2 17 2 17 2 17 2 17 2 17 2 17 2 17 2 17 2 17 2 17 2 17 2 17 2 17 2 17 2 17 2 17
2 17 2 17 2 17 2 17 2 17 2 17 2 59 59 59 59 59 59 59 59 59 59 59 59 59 59 59 59 59 59 59 59 59 59 59 59 59 59 59 59 59 59 59 2 17 2 17 2 17
2 17 2 17 2 17 2 17 2 17 2 17 2 59 2 17 2 17 2 17 2 17 2 17 2 17 2 17 2 17 2 17 2 17 2 17 2 17 2 17 2 17 2 59 2 17 2 17 2 17
2 17 2 17 2 17 2 17 2 17 2 17 2 59 2 17 2 17 36 32 32 32 32 32 32 32 32 32 32 32 32 32 37 17 2 17 2 17 2 17 2 17 2 59 2 17 2 17 2 17
2 17 2 17 2 17 2 17 2 17 2 17 2 59 2 17 2 17 30 4 4 4 4 4 4 4 4 4 4 4 4 4 31 17 2 17 2 17 2 17 2 17 2 59 2 17 2 17 2 17
2 17 2 17 2 17 2 17 2 17 2 17 2 59 2 17 2 17 30 4 4 4 4 4 4 4 4 4 4 4 4 4 31 17 2 17 2 17 2 17 2 17 2 59 2 17 2 17 2 17
2 17 2 17 2 17 2 17 2 17 2 17 2 59 2 17 2 17 30 4 4 4 4 4 4 4 4 4 4 4 4 4 31 17 2 17 2 17 2 17 2 17 2 59 2 17 2 17 2 17
2 17 2 17 2 17 2 17 2 17 2 17 2 59 2 17 2 17 30 4 4 4 4 4 4 4 4 4 4 4 4 4 31 17 2 17 2 17 2 17 2 17 2 59 2 17 2 17 2 17
2 17 2 17 2 17 2 17 2 17 2 17 2 59 2 17 2 17 34 33 33 33 33 33 33 4 33 33 33 33 33 33 35 2 2 17 2 17 2 17 2 17 2 59 2 17 2 17 2 17 2 17
2 17 2 17 2 17 2 17 2 17 2 17 2 59 2 17 2 17 2 17 2 17 2 17 2 29 2 17 2 17 2 17 2 17 2 17 2 17 2 17 2 17 2 59 2 17 2 17 2 17
2 17 2 17 2 17 2 17 2 17 2 17 2 59 2 17 2 17 2 17 2 17 2 17 2 29 2 17 2 17 2 17 2 17 2 17 2 17 2 17 2 17 2 59 2 17 2 17 2 17
2 17 2 17 2 17 2 17 2 17 2 17 2 59 2 17 2 17 2 17 2 17 2 17 2 29 2 17 2 17 2 17 2 17 2 17 2 17 2 17 2 17 2 59 2 17 2 17 2 17
2 17 2 17 2 17 2 17 2 17 2 17 2 59 2 17 2 17 2 17 2 17 2 17 2 29 2 17 2 17 2 17 2 17 2 17 2 17 2 17 2 17 2 59 2 17 2 17 2 17
2 17 2 17 2 17 2 17 2 17 2 17 2 59 2 17 2 17 2 17 2 17 2 17 2 29 2 17 2 17 2 17 2 17 2 17 2 17 2 17 2 17 2 59 2 17 2 17 2 17
2 17 2 17 2 17 2 17 2 17 2 17 2 59 2 17 2 17 2 17 2 17 2 17 2 29 2 17 2 17 2 17 2 17 2 17 2 17 2 17 2 17 2 59 2 17 2 17 2 17
2 17 2 17 2 17 2 17 2 17 2 17 2 59 2 17 2 17 2 17 2 17 2 17 2 29 2 17 2 17 2 17 2 17 2 17 2 17 2 17 2 17 2 59 2 17 2 17 2 17
2 17 2 17 2 17 2 17 2 17 2 17 2 59 2 17 2 17 2 17 2 17 2 17 2 29 2 17 2 17 2 17 2 17 2 17 2 17 2 17 2 17 2 59 2 17 2 17 2 17
2 17 2 17 2 17 2 17 2 17 2 17 2 59 59 59 59 59 59 59 59 59 59 59 59 29 59 59 59 59 59 59 59 59 59 59 59 59 59 59 59 59 59 59 17 2 17 2 17 2 17
2 17 2 17 2 17 2 17 2 17 2 17 2 17 2 17 2 17 2 17 2 17 2 17 59 29 59 17 2 17 2 17 2 17 2 17 2 17 2 17 2 17 2 17 2 17 2 17 2 17
2 17 2 17 2 17 2 17 2 17 2 17 2 17 2 17 2 17 2 17 2 17 2 17 59 29 59 2 17 2 17 2 17 2 17 2 17 2 17 2 17 2 17 2 17 2 17 2 17 17
2 17 2 17 2 17 2 17 2 17 2 17 2 17 2 17 2 17 2 17 2 17 2 17 59 29 59 17 2 17 2 17 2 17 2 17 2 17 2 17 2 17 2 17 2 17 2 17 2 17
2 17 2 17 2 17 2 17 2 17 2 17 2 17 2 17 2 17 2 17 2 17 2 17 59 29 59 17 2 17 2 17 2 17 2 17 2 17 2 17 2 17 2 17 2 17 2 17 2 17
2 17 2 17 2 17 2 17 2 17 2 17 2 17 2 17 2 17 2 17 2 17 2 17 59 29 59 17 2 17 2 17 2 17 2 17 2 17 2 17 2 17 2 17 2 17 2 17 2 17
2 17 2 17 2 17 2 17 2 17 2 17 2 17 2 17 2 17 2 17 2 17 2 17 59 29 59 17 2 17 2 17 2 17 2 17 2 17 2 17 2 17 2 17 2 17 2 17 2 17
2 17 2 17 2 17 2 17 2 17 2 17 2 17 2 17 2 17 2 17 2 17 2 17 59 29 59 17 2 17 2 17 2 17 2 17 2 17 2 17 2 17 2 17 2 17 2 17 2 17
2 17 2 17 2 17 2 17 2 17 2 17 2 17 2 17 2 17 2 17 2 17 2 17 59 29 59 17 2 17 2 17 2 17 2 17 2 17 2 17 2 17 2 17 2 17 2 17 2 17
2 17 2 17 2 17 2 17 2 17 2 17 2 17 2 17 2 17 2 17 2 17 2 17 59 29 59 17 2 17 2 17 2 17 2 17 2 17 2 17 2 17 2 17 2 17 2 17 2 17
2 17 2 17 2 17 2 17 2 17 2 17 2 17 2 17 2 17 2 17 2 17 2 17 59 29 59 17 2 17 2 17 2 17 2 17 2 17 2 17 2 17 2 17 2 17 2 17 2 17
2 17 2 17 2 17 2 17 2 17 2 17 2 17 2 17 2 17 2 17 2 17 2 17 59 29 59 17 2 17 2 17 2 17 2 17 2 17 2 17 2 17 2 17 2 17 2 17 2 17
2 17 2 17 2 17 2 17 2 17 2 17 2 17 2 17 2 17 2 17 2 17 2 17 59 29 59 17 2 17 2 17 2 17 2 17 2 17 2 17 2 17 2 17 2 17 2 17 2 17
2 17 2 17 2 17 2 17 2 17 2 17 2 17 2 17 2 17 2 17 2 17 2 17 59 29 59 17 2 17 2 17 2 17 2 17 2 17 2 17 2 17 2 17 2 17 2 17 2 17
2 17 2 17 2 17 2 17 2 17 2 17 2 17 2 17 2 17 2 17 2 17 2 17 59 29 59 17 2 17 2 17 2 17 2 17 2 17 2 17 2 17 2 17 2 17 2 17 2 17
2 17 2 17 2 17 2 17 2 17 2 17 2 17 2 17 2 17 2 17 2 17 2 17 59 29 59 17 2 17 2 17 2 17 2 17 2 17 2 17 2 17 2 17 2 17 2 17 2 17
2 17 2 17 2 17 2 17 2 17 2 17 2 17 2 17 2 17 2 17 2 17 2 17 59 29 59 17 2 17 2 17 2 17 2 17 2 17 2 17 2 17 2 17 2 17 2 17 2 17
2 17 2 17 2 17 2 17 2 17 2 17 2 17 2 17 2 17 2 17 2 17 2 17 59 29 59 17 2 17 2 17 2 17 2 17 2 17 2 17 2 17 2 17 2 17 2 17 2 17
2 17 2 17 2 17 2 17 2 17 2 17 2 17 2 17 2 17 2 17 2 17 2 17 59 29 59 17 2 17 2 17 2 17 2 17 2 17 2 17 2 17 2 17 2 17 2 17 2 17
2 17 2 17 2 17 2 17 2 17 2 17 2 17 2 17 2 17 2 17 2 17 2 17 59 29 59 17 2 17 2 17 2 17 2 17 2 17 2 17 2 17 2 17 2 17 2 17 2 17
2 17 2 17 2 17 2 17 2 17 2 17 2 17 2 17 2 17 2 17 2 17 2 17 59 29 59 17 2 17 2 17 2 17 2 17 2 17 2 17 2 17 2 17 2 17 2 17 2 17
2 17 2 17 2 17 2 17 2 17 2 17 2 17 2 17 2 17 2 17 2 17 2 17 59 29 59 17 2 17 2 17 2 17 2 17 2 17 2 17 2 17 2 17 2 17 2 17 2 17
2 17 2 17 2 17 2 17 2 17 2 17 2 17 2 17 2 17 2 17 2 17 2 17 59 29 59 17 2 17 2 17 2 17 2 17 2 17 2 17 2 17 2 17 2 17 2 17 2 17
2 17 2 17 2 17 2 17 2 17 2 17 2 17 2 17 2 17 2 17 2 17 2 17 59 29 59 17 2 17 2 17 2 17 2 17 2 17 2 17 2 17 2 17 2 17 2 17 2 17
2 17 2 17 2 17 2 17 2 17 2 17 2 17 2 17 2 17 2 17 2 17 2 17 59 61 59 17 2 17 2 17 2 17 2 17 2 17 2 17 2 17 2 17 2 17 2 17 2 17
